28 28
999 999 999 999 999 999 999 999 999 999 999 999 999 999 999 999 999 999 999 999 999 999 999 999 999 999 999 999 
999 999 10 10 10 10 10 999 999 999 999 999 10 10 10 999 999 999 999 999 999 999 999 999 999 999 999 999 
999 999 10 10 10 10 10 10 10 10 999 999 10 10 10 999 999 999 10 10 10 10 999 999 999 999 999 999 
999 999 10 10 10 10 10 999 999 10 999 999 10 10 10 999 999 999 999 999 999 10 999 999 999 999 999 999 
999 999 999 999 10 999 999 999 999 10 999 999 999 10 999 999 999 999 999 999 999 10 999 10 10 10 10 999 
999 999 999 999 10 999 999 999 999 10 10 10 10 10 10 10 10 10 10 999 999 10 10 10 10 10 10 999 
999 999 999 999 10 999 999 999 999 999 999 999 999 10 999 999 999 999 10 999 999 999 999 10 10 10 10 999 
999 999 10 10 10 10 10 999 999 999 999 999 999 999 999 999 999 999 10 999 999 999 999 10 10 10 10 999 
999 999 10 10 10 10 10 10 10 10 10 10 10 10 10 10 10 10 10 999 999 999 999 999 999 10 999 999 
999 999 10 10 10 10 10 999 999 999 999 999 999 999 999 999 999 999 999 999 999 999 999 999 999 10 999 999 
999 999 999 999 10 999 999 999 999 999 999 999 999 999 10 10 10 10 10 10 10 10 999 999 999 10 999 999 
999 999 999 999 10 999 999 999 999 999 999 999 999 999 10 10 10 10 10 10 10 10 999 999 999 10 999 999 
999 999 999 999 10 999 999 10 10 10 10 10 999 999 10 10 10 10 10 10 10 10 999 999 999 10 999 999 
999 999 10 10 10 10 10 10 10 10 10 10 10 10 10 999 999 999 10 999 999 999 999 999 999 10 999 999 
999 999 999 999 999 999 999 10 10 10 10 10 999 999 999 999 999 999 10 999 999 999 999 999 999 10 999 999 
999 999 999 999 10 999 999 999 999 10 999 999 999 999 999 999 10 10 10 10 10 999 999 999 999 10 999 999 
999 999 999 999 10 999 999 999 999 10 999 999 999 999 999 999 10 10 10 10 10 10 10 10 10 10 999 999 
999 999 999 999 10 999 999 999 999 10 10 10 10 10 999 999 10 10 10 10 10 999 999 999 999 10 999 999 
999 999 10 10 10 10 999 999 999 10 999 999 999 10 999 999 999 999 10 999 999 999 999 999 999 10 999 999 
999 999 10 999 999 10 999 999 999 10 999 999 999 10 999 999 999 999 10 999 999 999 999 999 999 10 999 999 
999 999 10 999 999 10 999 999 10 10 10 10 10 10 10 10 10 10 10 10 10 10 10 10 10 10 999 999 
999 999 10 999 999 999 999 999 999 999 999 999 999 999 999 999 999 999 10 999 999 999 999 10 999 999 999 999 
999 999 10 10 10 10 10 10 999 999 10 10 10 10 10 10 10 10 10 10 10 10 999 10 999 999 999 999 
999 999 10 999 999 10 10 10 999 999 10 999 999 10 999 999 999 999 10 999 999 999 999 10 999 999 999 999 
999 999 10 999 999 10 10 10 999 999 10 999 999 10 999 999 999 999 10 999 999 10 10 10 10 10 999 999 
999 999 10 999 999 10 10 10 10 10 10 999 10 10 10 999 999 999 10 10 10 10 10 10 10 10 999 999 
999 999 999 999 999 999 999 999 999 999 999 999 10 10 10 999 999 999 999 999 999 999 999 999 999 999 999 999 
999 999 999 999 999 999 999 999 999 999 999 999 999 999 999 999 999 999 999 999 999 999 999 999 999 999 999 999